R 1900 1000

NO textures/greystone.xpm
SO textures/greystone.xpm
EA textures/greystone.xpm
WE textures/greystone.xpm

S textures/pillar.xpm

C 60 50 100
F 50 50 50

111111111111111111111111111111111111111
100000020000000000002000000000002000001
10E000000000000000002000000000000000001
100000020000000000002000000000002000001
100000020000000000002000000000002000001
100000020000000000002000000000002000001
100000020000000000002000000000002000001
100000020000000000002000000000002000001
100000020000000000002000000000002000001
100000020000000000002000000000002000001
100000000000000000000000000000000000001
100000020000000000002000000000002000001
100000020000000000002000000000002000001
100000020000000000002000000000002000001
100000020000000000002000000000002000001
100000020000000000002000000000002000001
100000020000000000002000000000002000001
100000020000000000002000000000002000001
100000020000000000002000000000002000001
100000020000000000002000000000002000001
100000000000000000000000000000000000001
100000020000000000002000000000002000001
100000020000000000002000000000002000001
111111111111111111111111111111111111111
