R 1500 1000

NO textures/colorstone.xpm
SO textures/case.xpm
EA textures/greystone.xpm
WE textures/purplestone.xpm

S textures/pillar.xpm

C 100 230 210

1111111111111111111
1000000000000000001
10000000000P0000001
1000000000000000001
1111111111111111111
