R 1000 800

NO textures/colorstone.xpm
SO textures/case.xpm
EA textures/greystone.xpm
WE textures/purplestone.xpm

S textures/pillar.xpm

C 100 230 210
F 156 209 89

11111111111111111111111111111111
1000000022220010000000001   10001
100000020000010000001001   100001
11111110000N00000011111    111111
10000000000000000011
1000000000111111001
1111110000000000011
1111000000000000001
   111111111111111
