R 300 400

NO norte
SO sur
EA este
WE oeste

S sprite

C 100 230 210
F 156 209 89

11111111111111111111111
100000000000010000001
100000000000010000001
1111111000000000001111
10000000000000000011
1000000000111111001
1111110000000000011
1111000000000000001
   1111111111111111
