R 1000 800

NO textures/colorstone.xpm
SO textures/case.xpm
EA textures/greystone.xpm
WE textures/mossy.xpm

S sprite

F 100 230 210
C 156 209 89

11111111111111111111111111111111
1E0000000000010000000001   10001
100000000000010000001001   100001
11111110000000000011111    111111
10000000000000000011
1000000000111111001
1111110000000000011
1111000000000000001
   111111111111111
