R 1000 800

NO textures/colorstone.xpm
SO textures/case.xpm
EA textures/greystone.xpm
WE textures/mossy.xpm

S sprite

F 100 230 210
C 156 209 89

11111111111111
10000000000001
10000000000001
100000S0000001
10000000000001
10000000000001
10000000000001
11111111111111