R 1000 800

NO textures/colorstone.xpm
SO textures/case.xpm
EA textures/greystone.xpm
WE textures/mossy.xpm

S textures/pillar.xpm

C 10 23 50
F 17 74 36

11111111111111
10000200000021
10000000000001
10000000W00011
10000000000001
10000000000001
12000000000001
11111111111111
