R 1500 1000

NO textures/colorstone.xpm
SO textures/mossy.xpm
EA textures/greystone.xpm
WE textures/mossy.xpm

S textures/barrel.xpm

C 20 48 92
F 19 54 21

M music/minecraft.wav 
11111111111111111111111111111111111111111111
10020000200000000000000000000000002000000001
10000000000000000000000000000000000000000001
10000000000000000000000000000000000000000001
10000000011111111000000000011111111000000001
1000000001      10000N000001      1000000001
1000000001      100000000001      1000000001
10000000011111111111111111111111111000000001
100000000000000001        100000000000000001
100000000000000001        100000000000000001
100000000000011111        111110000000000001
10000000000001                10000000000001
10000000000001                10000000000001
10000000000001   1111111111   10000000000001
10000000000001   1000000001   10000000000001
10000000000001111100000000111110000000000001
10000000000000000000000000000000000000000001
11111111111111111111111111111111111111111111
