R 1900 1000

NO textures/greystone.xpm
SO textures/greystone.xpm
EA textures/greystone.xpm
WE textures/greystone.xpm

S textures/pillar.xpm


F 23 25 34
C 30 15 60

11111111111111
10000000000001
10020000020001
10000000W00001
10000000000001
10020000020001
10000000000001
11111111111111
