R 1800 1000

NO textures/colorstone.xpm
SO textures/case.xpm
EA textures/greystone.xpm
WE textures/purplestone.xpm

S textures/pillar.xpm

C 100 230 210
F 156 209 89

11111111111111111111111111111111
100000000020010000000001   10001
100000020000010000001001   100001
11111110000000000011111    1100011
100020000N0000000011       1110001
1000000000111111001          10001
1111110000000000011       11110011   
1111000000000000001      100000001
   11000000000000011     10000011      1111111111111111111111111111111111
1110000000000000001     10000011       1000000000000000000000000000000001
  10000000000000001111111000001        1000000001111111111111111111111111
  1000000000000000000000000001          10000001
111000000000000000000000000001          10001111
100000000000000000000000000001          10001
1000000000000000000000000000001        10001
10000000000000000000000000000001       10011 
100000000000000000002000000000001     10001
 100000000000000000020000000000001111100001
  10000000000000000220000000000000000000001
   1000000000000000000000000000000000011111
    1111111111111111111111111111111111
