R 1920 1080

NO textures/redbrick.xpm
SO textures/redbrick.xpm
WE textures/redbrick.xpm
EA textures/redbrick.xpm

S textures/greenlight.xpm

C 196, 157, 227
F 237, 166, 235

         111111111           11111111
        11000000011         1100000011
       1100000000011       110000000011
     1100000000000011     110000000000011
     11000000000000011   1100000000000011
    11000000000000000111110000000000000011
    11000000020000000000000000000020000011
    11000000000000000000000000000000000011
    11000000000000000000000000000000000011
    11000000000000000000000000000000000011
     110000000000000000N000000000000000011
      11000000000000000000000000000000011
        1100000000000000000000000000011
         11000000000000000000000000011
          110000000000000000000000011
           1100000000000000000000011
            11000000000000000000011
             110000000000200000011
               110000000000000011
                1100000000000011
                 11100000000111
                   1110000011
                     1100011
                       111
